1111111111111111111111111111111111
1E00000000000000000000000C00000001
1000010100100000101001001110010101
1011110010101010001001000000010101
100P000000000000000000000000000001
1111111111111111111111111111111111