1111111111111
1001000000011
1000011111110
1P00C0E000001
1111111111111
