11111111111111111111111111111
10000100010010010010010010011
11111100000000011110000001101
1P11111111111C111111111111111
10000000000000000000000000001
111111111111111111111111111E1
11111111111111111111111111111