1111111111111111111
1000000000C000000E1
1000000000000000001
1000000000000000001
10000C0CVC0C0000001
10000C0CVC0C0000001
10000C0CVC0C0000001
10000C0CVC0C0000001
10P00C0CV00C0000011
10000C0CVC0C0000001
10000C0CVC0C0000001
1111111111111111111