1111111111111111111111
101C001111111111111111
1010101111111111111111
1C00000P00000000C01111
1011101011111010111C11
11111110111010100C1011
1000111011111010111011
1C10101011111110101011
1110111010001C10111011
1C00C00C101010000000E1
1111111111111111111111
