1111111111111
1001000000011
1000011111
1P00C0E0   00001
1111111111111
