1111111111111111111
10000000000000001P1
100000000C0000000E1
10000C00000C0000V01
1111111111111111111