1111111111111111111
1000000000C000000E1
1000000000000000001
1000000000000000001
10000C0C1C0C0000001
10000C0C1C0C0000001
10000C0C1C0C0000001
10000C0C1C0C0000001
10P00C0C100C0000011
10000C0C1C0C0000001
10000C0C1C0C0000001
1111111111111111111