11111111111111111111
1P00000001C1000000E1
11111111111111111111