1111111111111111111
1000000000C000000E1
1000000000000000001
1000001111111111101
10000C1CVC0C0000001
10000C1CVC0C0000001
10000C1CVC0C0000001
10000C1CVC0C0000001
10P00C1CV00C0000011
10000C1CVC0C0000001
10000C1C0C0C0000001
1111111111111111111