111111110111
1P00000C00E1
111111111111